NO
SO
WE
EA
F
C
11111111111111
10000000000001
100000W0010001
100000001 1001
11111111010001
11111111111111