ne

se            .

w

11111
111 11
11111111111111
111111111  1111111111 111
111111111111 1 1 1 1 1 1 1
11111111111111111111111111
1100000011110000001
111110000110000011111111
100011111100000111000011
10000101010101010101010111111
1111111110000P0000000000011111111
11000001111100001110001101001
11111111111111111111111111111111
11111100000000111111100000001111
11111111111111111111111111111111