NO
SO
WE
EA
F
C
01111111111110
10000000000001
100000W0111001
10000001 1001
11111111111001
11111111111111